Ambermond	Red
Angeldrift	Black
Argenmomble	Red
Barcergos	Black
Coloris	Black
Couryonne	Black
Dawnpeak	Black
Elderpond	Black
Kinibourg	Black
Levannet	Black
Maplegrove	Black
Navalicia	Black
Orisca	Red
Pearlwater	Black
Ragewharf	Black
Steepgulch	Black
Stoneshire	Black
Tarbella	Black
Tenea	Black
Windvein	Black
